=;=;=;=;=;=;=;=;=;=;=;=
=;+;0;0;0;0;+;0;0;0;+;=
=;0;R;+;0;0;0;0;+;0;0;=
=;+;0;0;0;D;0;0;+;0;0;=
=;0;0;0;0;+;0;0;0;0;0;=
=;-;-;-;-;-;-;-;-;0;+;=
=;0;0;+;0;0;X;0;0;0;0;=
=;0;0;0;0;D;0;+;0;0;+;=
=;0;0;0;0;0;0;+;0;0;0;=
=;0;-;-;-;-;-;-;-;-;-;=
=;0;0;+;+;0;0;0;0;+;0;=
=;0;0;+;0;0;+;0;0;0;0;=
=;0;0;0;D;0;0;0;0;0;0;=
=;=;=;=;=;=;=;=;=;=;=;=
